[[5 4 3 7 6 0]
 [5 4 6 7 7 6]
 [5 4 6 7 7 7]
 [5 4 6 7 6 7]
 [5 4 3 6 5 6]
 [0 5 4 3 3 2]]