[[0 5 4 3 6 0]
 [0 0 5 4 3 6]
 [0 0 6 3 3 7]
 [0 0 5 4 6 7]
 [0 0 5 4 3 6]
 [0 0 0 6 3 2]]